##########
#...db...#
#.b##.##.#
#....bJ.b#
#....d#..#
##########