##########
#...db...#
#.bb#.##.#
#.dJ.b...#
#....d#..#
##########